1111111111111111111111111
1100111100000000000100011
1000000001010101111111001
1011111101010101111111011
1000000101010101000100001
1011110101010101011111101
1011110100000001000001001
1011110111111101010101101
1000000010010001010101001
1111110010010001010101101
1000010110010111010101001
1011010110010111010100001
1011010110110111010111101
1011010010100000010100001
1011010010111111110101101
1001011000111110000101101
1001011000000000111101001
1101010011111110000101011
1001110010000111110100001
1000000010000000000101101
1111011110010001010100101
1000010000010101010110101
1001010111010101010100101
1001010111010101010101101
1001010111010101010100101
1001010111010101011110101
1111010000000001011000001
1000010111111111011011011
1001010000000000000000001
1111111111111111111111111